R  1280   768
NO ./texture/mossy.xpm
SO ./texture/redbrick.xpm
WE ./texture/greystone.xpm  
S ./texture/barrel.xpm
EA ./texture/wood.xpm

F 0,100,0
C 0,0,160
        1111111111111111111111111
        1000000011000000000000021
        1011000001110000022200001
        1001000000000000020000001
111111111011000001110000000000021
100000000011000001110111110111111
11110111111111011100000010001
11110111111111011101010010001
11000000110101011100000010001
10002000000020001100000010001
10000000000000000001010010001
11000001110101011111011110N01
11110111 1110101 101111010001
11111111 1111111 111111111111
